5x5
1 1 1 1 1
1 1 0 q 1
1 0 0 0 1
1 m 1 1 1
1 1 1 1 1